################### #############################
#                        ########################
####### #########################################
####### #########################################
#                                               #
######################################## ###### #
#####     #####  ####  ######      #####  ####  #
#####  ########  ####  ######  ##  #####  ####  #
#####     #####  ####  ######    #######  ####  #
########  #####  ####  ######  ##  #####  ####  #
#####     #####        ######      #####        #
############################################## ##
######### ####  ######## ########## ########## ##
#     ### ####  ##    ## ##########     ###    ##
##### ### ####  ## ## ## ########## ###  ## #####
##### ### ####  ##### ## ########## ####    #####
##### ###  ###        ## ###        #############
##### #### ################# ####################
#####                        ####################
##### ###########################################
